###############################
#..P...B.....E.......F....O...#
#.............................#
#...####.......#....K.........#
#.....TTTT...I.#..............#
#.........O....#.........S....#
#..B.........D.#..............#
#.....E.............E.........#
#..............O...........O..#
#.....K.............D.........#
#............................X#
###############################