##########
#...E....#
#....E...#
#........#
#...E....#
#.......P#
##########
